/jy	惊讶
/pz	撇嘴
/se	色
/fd	发呆
/dy	得意
/ll	流泪
/hx	害羞
/bz	闭嘴
/shui	睡
/dk	大哭
/gg	尴尬
/fn	发怒
/tp	调皮
/cy	呲牙
/wx	微笑
/ng	难过
/kuk	酷
/feid	非典
/zk	抓狂
/tu	吐
/tx	偷笑
/ka	可爱
/baiy	白眼
/am	傲慢
/jie	饥饿
/kun	困
/jk	惊恐
/lh	流汗
/hanx	憨笑
/db	大兵
/fendou	奋斗
/zhm	咒骂
/yiw	疑问
/xu	嘘...
/yun	晕
/zhem	折磨
/shuai	衰
/kl	骷髅
/qiao	敲打
/zj	再见
/shan	闪人
/fad	发抖
/aiq	爱情
/tiao	跳
/zhao	找
/mm	美眉
/zt	猪头
/maom	猫咪
/xg	小狗
/yb	拥抱
/qianc	钱
/dp	灯泡
/bei	酒杯
/dg	蛋糕
/shd	闪电
/zhd	炸弹
/dao	刀
/zq	足球
/yy	音乐
/bb	便便
/kf	咖啡
/fan	饭
/yw	药丸
/mg	玫瑰
/dx	凋谢
/wen	吻
/xin	爱心
/xs	心碎
/hy	会议
/lw	礼物
/dh	电话
/sj	时间
/yj	邮件
/ds	电视
/ty	太阳
/yl	月亮
/qiang	强
/ruo	弱
/ws	握手
/shl	胜利
/dd	多多
/mn	美女
/hl	汉良
/maomao	毛毛
/qz	Q仔
/fw	飞吻
/oh	怄火
/bj	白酒
/qsh	汽水
/xig	西瓜
/xy	下雨
/duoy	多云
/xr	雪人
/xixing	星星
/nv	女
/nan	男
